"date","new_cases","cases_accumulated","pcr","TestAc","Muestras.PCR","Muestras.TestAc","muestras_totales","IA14","deceased","fallec_diarios","intensive_care","hospitalized","ocu_UCI_covid","ocu_hospi_covid","ocu_UCI_total","ocu_hospi_total","altas24h_total_covid"
"2020-12-16",91,25954,84,7,25456,498,495300,195.248,1270,10,83,409,24.85,12.951,39.222,68.841,68
"2020-12-15",117,25863,113,4,25372,491,491885,208.643,1260,8,92,444,27.545,14.064,41.617,69.591,72
"2020-12-14",123,25746,111,12,25259,487,487466,220.669,1252,13,99,480,29.118,15.204,51.176,70.763,55
"2020-12-13",143,25623,133,10,25148,475,483914,223.113,1239,4,110,483,32.353,15.299,44.412,69.433,13
"2020-12-12",96,25480,95,1,25015,465,480585,227.219,1235,8,112,465,32.941,14.748,47.941,66.127,26
"2020-12-11",177,25384,166,11,24920,464,476990,231.912,1227,14,117,474,34.412,15.033,46.765,65.461,104
"2020-12-10",131,25207,127,4,24754,453,471712,240.321,1213,15,117,549,34.412,17.401,45.882,72.647,92
"2020-12-09",130,25076,121,9,24627,449,466501,255.573,1198,17,123,575,36.176,18.225,49.412,71.791,79
"2020-12-08",108,24946,104,4,24506,440,463342,268.479,1181,11,129,588,37.941,18.637,48.824,69.572,33
"2020-12-07",103,24838,99,4,24402,436,460560,297.028,1170,16,128,597,37.647,18.922,50,65.357,33
"2020-12-06",117,24735,112,5,24303,432,457816,308.467,1154,6,127,604,37.353,19.15,49.412,63.412,34
"2020-12-05",230,24618,222,8,24191,427,455287,321.373,1148,14,122,604,35.882,19.291,47.059,62.696,32
"2020-12-04",198,24388,177,21,23969,419,450738,330.368,1134,15,124,600,36.471,19.042,47.647,62.805,138
"2020-12-03",233,24190,216,17,23792,398,445830,345.913,1119,19,129,669,37.83,21.326,47.801,69.398,90
"2020-12-02",228,23957,213,15,23576,381,440346,354.908,1100,20,133,634,39.003,20.249,51.026,69.115,98
"2020-12-01",240,23729,220,20,23363,366,434750,377.395,1080,16,134,695,39.296,22.197,49.853,70.393,89
"2020-11-30",148,23489,129,19,23143,346,428570,392.941,1064,17,131,707,38.416,22.581,47.214,70.297,83
"2020-11-29",185,23341,181,4,23014,327,423611,406.922,1047,21,130,750,38.123,23.916,46.041,69.898,35
"2020-11-28",144,23156,137,7,22833,323,419536,412.691,1026,10,133,732,39.003,23.342,46.921,66.996,25
"2020-11-27",263,23012,232,31,22696,316,414456,441.826,1016,27,132,702,38.71,22.385,47.801,65.561,114
"2020-11-26",287,22749,276,11,22464,285,408959,495.014,989,26,136,737,39.883,23.427,47.801,69.231,139
"2020-11-25",262,22462,239,23,22188,274,402306,532.949,963,24,144,753,42.229,23.935,51.613,70.788,146
"2020-11-24",400,22200,375,25,21949,251,396684,567.266,939,25,145,800,43.284,25.429,52.836,71.774,140
"2020-11-23",220,21800,199,21,21574,226,389848,579.097,914,29,144,846,42.985,26.866,49.552,73.611,109
"2020-11-22",249,21580,238,11,21375,205,385091,586.429,885,14,140,870,46.512,27.663,53.156,75.231,38
"2020-11-21",322,21331,308,14,21137,194,381113,608.037,871,23,140,824,46.512,26.2,55.814,72.337,65
"2020-11-20",357,21009,332,25,20829,180,375808,605.104,848,23,143,789,47.508,25.119,57.475,70.423,163
"2020-11-19",325,20652,295,30,20497,155,369128,624.756,825,28,143,841,47.508,26.775,58.472,76.154,134
"2020-11-18",458,20327,428,30,20202,125,363372,650.274,797,18,150,868,49.834,27.652,59.136,76.999,106
"2020-11-17",399,19869,363,36,19774,95,357145,648.123,779,16,143,884,47.508,28.18,55.482,77.973,147
"2020-11-16",291,19470,273,18,19411,59,350073,637.466,763,11,143,894,47.508,28.499,56.811,77.781,128
"2020-11-15",244,19179,236,8,19138,41,345000,633.066,752,27,145,893,48.173,28.458,55.482,76.322,46
"2020-11-14",442,18935,435,7,18902,33,340491,628.178,725,26,140,858,46.512,27.342,55.482,73.901,51
"2020-11-13",807,18493,792,15,18467,26,335180,613.219,699,25,140,814,46.512,25.94,53.821,72.116,137
"2020-11-12",675,17686,668,7,17675,11,328189,575.186,674,18,138,843,46.465,26.899,53.872,76.771,85
"2020-11-11",613,17011,609,4,17007,4,321960,552.601,656,11,133,823,45.862,26.26,54.138,76.101,88
"2020-11-10",521,16398,521,0,16398,0,315892,532.46,645,20,128,806,44.138,25.751,51.724,75.208,117
"2020-11-09",295,15877,295,0,15877,0,309047,515.35,625,21,129,795,46.237,25.432,54.48,74.536,95
"2020-11-08",470,15582,470,0,15582,0,304545,510.266,604,13,129,796,46.237,25.488,55.556,74.191,27
"2020-11-07",292,15112,292,0,15112,0,299791,488.463,591,20,125,743,44.803,23.799,53.047,70.756,39
"2020-11-06",558,14820,558,0,14820,0,295497,489.636,571,23,121,685,43.369,21.955,54.48,68.173,108
"2020-11-05",586,14262,586,0,14262,0,289548,472.526,548,16,111,680,39.785,21.795,48.387,71.346,78
"2020-11-04",436,13676,436,0,13676,0,283870,446.813,532,25,115,661,41.219,21.412,48.029,72.465,106
"2020-11-03",290,13240,290,0,13240,0,279313,430.583,507,8,108,690,38.71,22.272,46.237,72.95,53
"2020-11-02",246,12950,246,0,12950,0,275052,420.317,499,17,107,647,38.351,20.918,45.52,72.098,22
"2020-11-01",194,12704,194,0,12704,0,271833,416.797,482,14,99,572,35.357,18.452,41.071,67.774,20
"2020-10-31",289,12510,289,0,12510,0,268723,422.761,468,10,92,534,32.857,17.226,39.286,66.419,27
"2020-10-30",418,12221,418,0,12221,0,264226,421.783,458,7,82,509,30.258,16.393,39.483,65.668,74
"2020-10-29",444,11803,444,0,11803,0,259197,401.251,451,10,74,499,27.306,16.112,36.531,71.456,49
"2020-10-28",407,11359,407,0,11359,0,254248,377.395,441,7,69,459,25.461,14.792,36.531,72.736,65
"2020-10-27",346,10952,346,0,10952,0,248952,356.081,434,7,61,444,22.509,14.3,33.948,73.591,65
"2020-10-26",243,10606,243,0,10606,0,243335,340.34,427,6,53,429,20.385,13.924,33.462,74.976,36
"2020-10-25",247,10363,247,0,10363,0,239633,330.27,421,3,50,428,18.45,13.736,31.365,74.198,27
"2020-10-24",304,10116,304,0,10116,0,236507,321.862,418,8,49,364,18.081,11.712,31.734,69.176,19
"2020-10-23",383,9812,383,0,9812,0,231873,315.506,410,8,43,345,16.538,11.489,30,68.099,47
"2020-10-22",323,9429,323,0,9429,0,226959,300.645,402,7,40,316,15.385,10.512,28.846,74.118,31
"2020-10-21",270,9106,270,0,9106,0,222261,280.896,395,9,39,295,14.182,9.28,27.636,72.727,29
"2020-10-20",185,8836,185,0,8836,0,217521,266.132,386,5,39,284,14.182,9.022,29.455,73.571,37
"2020-10-19",210,8651,210,0,8651,0,213069,259.484,381,2,39,277,14.773,9.103,30.682,74.893,12
"2020-10-18",255,8441,255,0,8441,0,209998,247.165,379,2,35,250,12.727,7.889,28,72.988,7
"2020-10-17",279,8186,279,0,8186,0,206822,231.228,377,2,35,232,12.727,7.323,26.909,69.255,6
"2020-10-16",208,7907,208,0,7907,0,202960,213.238,375,3,32,210,11.636,6.602,26.182,67.966,27
"2020-10-15",200,7699,200,0,7699,0,199216,206.785,372,1,35,213,12.727,6.646,29.091,73.261,24
"2020-10-14",189,7499,189,0,7499,0,195119,194.662,371,2,29,197,10.701,6.17,26.937,73.317,22
"2020-10-13",185,7310,185,0,7310,0,191146,186.645,369,4,25,185,9.225,5.79,27.306,72.582,24
"2020-10-12",140,7125,140,0,7125,0,187978,175.303,365,1,27,160,9.963,5.002,28.044,70.084,9
"2020-10-11",161,6985,161,0,6985,0,184833,168.166,364,0,24,157,8.856,5.003,27.306,68.133,3
"2020-10-10",239,6824,239,0,6824,0,181647,158.584,364,0,21,137,7.749,4.366,25.83,66.316,5
"2020-10-09",231,6585,231,0,6585,0,177888,146.07,364,2,22,116,8.118,3.699,27.306,65.784,17
"2020-10-08",121,6354,121,0,6354,0,174158,136.097,362,3,25,112,9.69,3.561,28.682,71.638,13
"2020-10-07",119,6233,119,0,6233,0,169758,133.164,359,1,24,103,9.302,3.272,29.845,72.745,14
"2020-10-06",117,6114,117,0,6114,0,165983,131.306,358,1,21,100,8.14,3.177,28.295,72.236,14
"2020-10-05",84,5997,84,0,5997,0,162287,127.786,357,0,21,85,8.14,2.701,27.907,70.289,11
"2020-10-04",92,5913,92,0,5913,0,159637,126.222,357,0,20,89,7.752,2.853,25.969,70.096,4
"2020-10-03",95,5821,95,0,5821,0,157350,122.8,357,0,18,70,7.287,2.319,23.887,66.115,4
"2020-10-02",142,5726,142,0,5726,0,154953,126.515,357,0,18,70,7.287,2.319,25.911,65.816,7
"2020-10-01",76,5584,76,0,5584,0,151608,122.018,357,1,17,59,6.589,1.889,22.868,63.668,3
"2020-09-30",107,5508,107,0,5508,0,148323,123.68,356,3,14,55,5.426,1.761,22.481,69.782,11
"2020-09-29",69,5401,69,0,5401,0,144801,121.04,353,2,16,58,6.202,1.869,23.256,69.62,14
"2020-09-28",67,5332,67,0,5332,0,141239,121.138,351,0,17,60,6.589,1.933,24.031,67.977,5
"2020-09-27",63,5265,63,0,5265,0,138407,119.671,351,0,14,59,5.426,1.901,26.357,64.369,3
"2020-09-26",111,5202,111,0,5202,0,136674,120.356,351,1,15,51,5.814,1.643,25.969,61.92,2
"2020-09-25",129,5091,129,0,5091,0,133507,115.956,350,0,12,49,4.651,1.579,24.419,61.082,13
"2020-09-24",91,4962,91,0,4962,0,129877,111.557,350,1,11,59,4.264,1.909,27.907,67.54,5
"2020-09-23",100,4871,100,0,4871,0,125777,106.961,349,0,13,49,5.039,1.586,26.744,67.217,3
"2020-09-22",81,4771,81,0,4771,0,122158,99.628,349,0,13,51,5.039,1.65,27.907,68.22,6
"2020-09-21",68,4690,68,0,4690,0,118878,97.966,349,1,11,51,4.264,1.638,25.194,69.075,6
"2020-09-20",57,4622,57,0,4622,0,116516,92.687,348,0,11,43,4.264,1.381,21.318,66.153,0
"2020-09-19",133,4565,133,0,4565,0,114355,92.491,348,0,12,40,4.651,1.285,20.93,64.162,1
"2020-09-18",96,4432,96,0,4432,0,110767,84.474,348,0,13,37,5.039,1.188,21.705,63.68,6
"2020-09-17",93,4336,93,0,4336,0,106785,81.639,348,0,12,40,4.651,1.285,25.194,68.979,7
"2020-09-16",80,4243,80,0,4243,0,102696,77.63,348,1,10,40,3.876,1.285,24.419,67.502,7
"2020-09-15",70,4163,70,0,4163,0,98934,75.968,347,0,11,45,4.264,1.506,24.031,66.801,8
"2020-09-14",52,4093,52,0,4093,0,95568,72.937,347,1,11,49,4.453,1.628,21.457,67.198,7
"2020-09-13",70,4041,70,0,4041,0,93182,70.688,346,0,10,49,3.876,1.574,21.705,65.511,5
"2020-09-12",66,3971,66,0,3971,0,91449,66.484,346,0,9,47,3.488,1.509,18.992,61.432,0
"2020-09-11",84,3905,84,0,3905,0,89137,63.062,346,1,9,50,3.488,1.606,20.155,60.18,9
"2020-09-10",44,3821,44,0,3821,0,86075,59.249,345,0,9,57,3.488,1.83,21.318,66.956,2
"2020-09-09",25,3777,25,0,3777,0,82920,58.467,345,0,9,48,3.488,1.541,22.093,66.988,3
"2020-09-08",64,3752,64,0,3752,0,81265,59.64,345,0,8,48,3.101,1.541,20.543,65.093,5
"2020-09-07",14,3688,14,0,3688,0,78849,57.88,345,1,7,42,2.713,1.349,22.481,60.854,4
"2020-09-06",55,3674,55,0,3674,0,77246,61.4,344,0,7,50,2.713,1.606,22.093,63.102,7
"2020-09-05",51,3619,51,0,3619,0,75357,57.88,344,0,7,38,2.713,1.22,22.093,59.666,1
"2020-09-04",67,3568,67,0,3568,0,72949,55.436,344,1,4,39,1.55,1.252,18.992,58.767,7
"2020-09-03",52,3501,52,0,3501,0,70106,51.916,343,1,5,43,1.938,1.381,20.93,63.873,7
"2020-09-02",63,3449,63,0,3449,0,67123,50.743,342,0,4,46,1.55,1.477,21.705,65.671,0
"2020-09-01",39,3386,39,0,3386,0,64451,46.832,342,0,5,41,1.938,1.317,21.705,66.185,5
"2020-08-31",29,3347,29,0,3347,0,61717,45.952,342,0,4,35,1.55,1.124,21.318,65.446,6
"2020-08-30",27,3318,27,0,3318,0,59649,44.975,342,0,4,40,1.55,1.285,22.093,63.423,5
"2020-08-29",31,3291,31,0,3291,0,58245,44.095,342,0,3,34,1.163,1.092,22.481,59.698,0
"2020-08-28",45,3260,45,0,3260,0,56401,43.312,342,0,3,32,1.163,1.028,21.705,58.51,1
"2020-08-27",36,3215,36,0,3215,0,54400,42.139,342,0,2,18,0.775,0.578,21.705,62.267,1
"2020-08-26",37,3179,37,0,3179,0,52232,40.77,342,0,2,21,0.775,0.674,20.93,63.102,2
"2020-08-25",46,3142,46,0,3142,0,49812,39.793,342,0,2,22,0.775,0.706,22.481,65.478,1
"2020-08-24",50,3096,50,0,3096,0,47784,37.348,342,0,2,17,0.775,0.546,20.543,64.419,1
"2020-08-23",19,3046,19,0,3046,0,45550,33.829,342,1,3,14,1.163,0.45,23.256,62.62,2
"2020-08-22",26,3027,26,0,3027,0,44506,33.535,341,0,4,13,1.55,0.417,21.705,58.96,0
"2020-08-21",31,3001,31,0,3001,0,42912,33.438,341,0,5,12,1.938,0.385,19.38,57.707,3
"2020-08-20",40,2970,40,0,2970,0,40844,32.851,341,0,3,19,1.163,0.61,21.318,63.487,7
"2020-08-19",23,2930,23,0,2930,0,38666,31.678,341,0,3,17,1.163,0.546,22.481,63.295,4
"2020-08-18",30,2907,30,0,2907,0,36330,32.753,341,0,3,21,1.163,0.674,22.093,63.648,2
"2020-08-17",19,2877,19,0,2877,0,33710,31.189,341,0,3,20,1.163,0.642,24.031,63.423,2
"2020-08-16",18,2858,18,0,2858,0,31552,29.918,341,0,3,15,1.163,0.482,20.93,61.85,1
"2020-08-15",23,2840,23,0,2840,0,30294,28.94,341,0,3,11,1.163,0.353,20.93,58.092,0
"2020-08-14",33,2817,33,0,2817,0,28703,28.158,341,0,3,13,1.163,0.417,19.767,57.836,0
"2020-08-13",22,2784,22,0,2784,0,26847,26.398,341,0,2,15,0.81,0.499,19.838,62.014,3
"2020-08-12",27,2762,27,0,2762,0,24761,26.203,341,0,3,11,1.163,0.353,19.38,62.813,0
"2020-08-11",21,2735,21,0,2735,0,22829,24.932,341,0,3,11,1.163,0.353,21.318,61.914,0
"2020-08-10",14,2714,14,0,2714,0,20735,24.149,341,0,4,7,1.55,0.225,20.543,61.593,0
"2020-08-09",16,2700,16,0,2700,0,19092,22.976,341,0,4,8,1.619,0.266,20.648,61.449,0
"2020-08-08",25,2684,25,0,2684,0,17554,21.901,341,0,5,10,1.938,0.321,18.605,57.354,0
"2020-08-07",25,2659,25,0,2659,0,15630,20.043,341,0,4,10,1.55,0.321,17.829,56.23,0
"2020-08-06",28,2634,28,0,2634,0,12921,17.697,341,0,4,6,1.619,0.199,21.457,62.546,0
"2020-08-05",34,2606,34,0,2606,0,10792,15.154,341,0,4,8,1.619,0.266,22.267,64.44,3
"2020-08-04",14,2572,14,0,2572,0,8516,12.221,341,0,4,9,1.619,0.299,19.433,64.407,0
"2020-08-03",6,2558,6,0,2558,0,6243,10.95,341,0,4,12,1.619,0.399,21.457,63.942,0
"2020-08-02",8,2552,8,0,2552,0,3982,10.559,341,0,5,5,2.024,0.166,20.243,62.558,0
"2020-08-01",15,2544,15,0,2544,0,2341,9.875,341,0,5,5,1.938,0.161,18.217,59.775,0
"2020-07-31",15,2529,15,0,2529,0,NA,8.506,341,0,4,6,1.55,0.193,20.543,58.844,2
"2020-07-30",20,2514,20,0,2514,0,NA,7.137,341,0,3,11,1.163,0.353,20.155,63.263,2
"2020-07-29",14,2494,14,0,2494,0,NA,5.182,341,0,3,10,1.215,0.332,21.053,64.827,0
"2020-07-28",13,2480,13,0,2480,0,NA,3.813,341,1,3,15,1.215,0.499,22.267,66.235,0
"2020-07-27",2,2467,2,0,2467,0,NA,2.542,340,0,3,17,1.163,0.546,20.543,65.907,1
"2020-07-26",5,2465,5,0,2465,0,NA,2.835,340,0,NA,NA,NA,NA,NA,NA,NA
"2020-07-25",6,2460,6,0,2460,0,NA,2.346,340,0,3,15,1.163,0.481,21.705,59.756,0
"2020-07-24",1,2454,1,0,2454,0,NA,1.76,340,0,4,14,1.55,0.449,21.705,58.788,0
"2020-07-23",2,2453,2,0,2453,0,NA,1.662,340,0,3,16,1.215,0.531,24.291,65.692,0
"2020-07-22",4,2451,4,0,2451,0,NA,1.564,340,0,3,13,1.215,0.431,23.482,66.313,0
"2020-07-21",1,2447,1,0,2447,0,NA,1.173,340,0,3,12,1.163,0.385,20.155,65.983,0
"2020-07-20",2,2446,2,0,2446,0,NA,1.173,340,0,4,9,1.619,0.298,21.862,65.749,1
"2020-07-19",1,2444,1,0,2444,0,NA,0.978,340,0,3,15,1.215,0.498,23.482,63.458,0
"2020-07-18",1,2443,1,0,2443,0,NA,0.88,340,0,3,14,1.163,0.449,21.705,58.344,0
"2020-07-17",1,2442,1,0,2442,0,NA,0.782,340,0,4,14,1.55,0.449,21.318,57.652,0
"2020-07-16",0,2441,0,0,2441,0,NA,0.684,340,0,3,8,1.163,0.256,20.155,61.769,0
"2020-07-15",0,2441,0,0,2441,0,NA,0.684,340,0,4,12,1.55,0.383,24.806,64.005,0
"2020-07-14",0,2441,0,0,2441,0,NA,0.684,340,0,4,17,1.55,0.543,22.093,65.187,0
"2020-07-13",5,2441,5,0,2441,0,NA,0.684,340,0,3,11,1.163,0.352,20.155,65.548,0
"2020-07-12",0,2436,0,0,2436,0,NA,0.196,340,0,3,19,1.163,0.61,22.481,64.109,0
"2020-07-11",0,2436,0,0,2436,0,NA,0.196,340,0,3,14,1.163,0.45,22.481,60.116,1
"2020-07-10",0,2436,0,0,2436,0,NA,0.196,340,0,3,11,1.163,0.353,19.767,59.872,0
"2020-07-09",1,2436,1,0,2436,0,NA,0.196,340,0,3,8,1.176,0.255,23.137,64.365,0
"2020-07-08",0,2435,0,0,2435,0,NA,0.098,340,0,3,6,1.176,0.191,27.059,64.971,0
"2020-07-07",1,2435,1,0,2435,0,NA,0.098,340,0,NA,NA,NA,NA,NA,NA,NA
"2020-07-06",0,2434,0,0,2434,0,NA,0,340,0,NA,NA,NA,NA,NA,NA,NA
"2020-07-05",0,2434,0,0,2434,0,NA,0,340,0,NA,NA,NA,NA,NA,NA,NA
"2020-07-04",0,2434,0,0,2434,0,NA,0,340,0,NA,NA,NA,NA,NA,NA,NA
"2020-07-03",0,2434,0,0,2434,0,NA,0,340,0,NA,NA,NA,NA,NA,NA,NA
"2020-07-02",0,2434,0,0,2434,0,NA,0,340,0,NA,NA,NA,NA,NA,NA,NA
"2020-07-01",0,2434,0,0,2434,0,NA,0,340,1,NA,NA,NA,NA,NA,NA,NA
"2020-06-30",0,2434,0,0,2434,0,NA,0,339,2,NA,NA,NA,NA,NA,NA,NA
"2020-06-29",0,2434,0,0,2434,0,NA,0,337,0,NA,NA,NA,NA,NA,NA,NA
"2020-06-28",0,2434,0,0,2434,0,NA,0,337,0,NA,NA,NA,NA,NA,NA,NA
"2020-06-27",0,2434,0,0,2434,0,NA,0,337,0,NA,NA,NA,NA,NA,NA,NA
"2020-06-26",0,2434,0,0,2434,0,NA,0,337,0,NA,NA,NA,NA,NA,NA,NA
"2020-06-25",0,2434,0,0,2434,0,NA,0,337,0,NA,NA,NA,NA,NA,NA,NA
"2020-06-24",0,2434,0,0,2434,0,NA,0.391,337,0,NA,NA,NA,NA,NA,NA,NA
"2020-06-23",0,2434,0,0,2434,0,NA,0.391,337,0,NA,NA,NA,NA,NA,NA,NA
"2020-06-22",0,2434,0,0,2434,0,NA,0.391,337,0,NA,NA,NA,NA,NA,NA,NA
"2020-06-21",0,2434,0,0,2434,0,NA,0.489,337,1,NA,NA,NA,NA,NA,NA,NA
"2020-06-20",0,2434,0,0,2434,0,NA,0.684,336,1,NA,NA,NA,NA,NA,NA,NA
"2020-06-19",0,2434,0,0,2434,0,NA,0.782,335,0,NA,NA,NA,NA,NA,NA,NA
"2020-06-18",0,2434,0,0,2434,0,NA,0.978,335,0,NA,NA,NA,NA,NA,NA,NA
"2020-06-17",0,2434,0,0,2434,0,NA,0.978,335,0,NA,NA,NA,NA,NA,NA,NA
"2020-06-16",0,2434,0,0,2434,0,NA,0.978,335,1,NA,NA,NA,NA,NA,NA,NA
"2020-06-15",0,2434,0,0,2434,0,NA,0.978,334,0,NA,NA,NA,NA,NA,NA,NA
"2020-06-14",0,2434,0,0,2434,0,NA,0.978,334,0,NA,NA,NA,NA,NA,NA,NA
"2020-06-13",0,2434,0,0,2434,0,NA,1.173,334,0,NA,NA,NA,NA,NA,NA,NA
"2020-06-12",0,2434,0,0,2434,0,NA,1.369,334,0,NA,NA,NA,NA,NA,NA,NA
"2020-06-11",4,2434,4,0,2434,0,NA,3.324,334,1,NA,NA,NA,NA,NA,NA,NA
"2020-06-10",0,2430,0,0,2430,0,NA,3.129,333,1,NA,NA,NA,NA,NA,NA,NA
"2020-06-09",0,2430,0,0,2430,0,NA,3.226,332,1,NA,NA,NA,NA,NA,NA,NA
"2020-06-08",1,2430,1,0,2430,0,NA,3.226,331,0,NA,NA,NA,NA,NA,NA,NA
"2020-06-07",2,2429,2,0,2429,0,NA,3.129,331,1,NA,NA,NA,NA,NA,NA,NA
"2020-06-06",1,2427,1,0,2427,0,NA,3.129,330,2,NA,NA,NA,NA,NA,NA,NA
"2020-06-05",2,2426,2,0,2426,0,NA,3.226,328,2,NA,NA,NA,NA,NA,NA,NA
"2020-06-04",0,2424,0,0,2424,0,NA,3.031,326,2,NA,NA,NA,NA,NA,NA,NA
"2020-06-03",0,2424,0,0,2424,0,NA,3.129,324,1,NA,NA,NA,NA,NA,NA,NA
"2020-06-02",0,2424,0,0,2424,0,NA,3.129,323,0,NA,NA,NA,NA,NA,NA,NA
"2020-06-01",0,2424,0,0,2424,0,NA,3.226,323,0,NA,NA,NA,NA,NA,NA,NA
"2020-05-31",2,2424,2,0,2424,0,NA,3.52,323,1,NA,NA,NA,NA,NA,NA,NA
"2020-05-30",2,2422,2,0,2422,0,NA,3.715,322,7,NA,NA,NA,NA,NA,NA,NA
"2020-05-29",20,2420,20,0,2420,0,NA,3.52,315,0,NA,NA,NA,NA,NA,NA,NA
"2020-05-28",2,2400,2,0,2400,0,NA,1.76,315,0,NA,NA,NA,NA,NA,NA,NA
"2020-05-27",1,2398,1,0,2398,0,NA,2.249,315,1,NA,NA,NA,NA,NA,NA,NA
"2020-05-26",0,2397,0,0,2397,0,NA,2.249,314,1,NA,NA,NA,NA,NA,NA,NA
"2020-05-25",0,2397,0,0,2397,0,NA,2.64,313,0,NA,NA,NA,NA,NA,NA,NA
"2020-05-24",2,2397,2,0,2397,0,NA,2.835,313,1,NA,NA,NA,NA,NA,NA,NA
"2020-05-23",2,2395,2,0,2395,0,NA,3.031,312,1,NA,NA,NA,NA,NA,NA,NA
"2020-05-22",0,2393,0,0,2393,0,NA,3.031,311,0,NA,NA,NA,NA,NA,NA,NA
"2020-05-21",1,2393,1,0,2393,0,NA,3.618,311,1,NA,NA,NA,NA,NA,NA,NA
"2020-05-20",0,2392,0,0,2392,0,NA,4.302,310,2,NA,NA,NA,NA,NA,NA,NA
"2020-05-19",1,2392,1,0,2392,0,NA,5.182,308,2,NA,NA,NA,NA,NA,NA,NA
"2020-05-18",3,2391,3,0,2391,0,NA,5.573,306,2,NA,NA,NA,NA,NA,NA,NA
"2020-05-17",4,2388,4,0,2388,0,NA,5.377,304,3,NA,NA,NA,NA,NA,NA,NA
"2020-05-16",0,2384,0,0,2384,0,NA,5.182,301,0,NA,NA,NA,NA,NA,NA,NA
"2020-05-15",2,2384,2,0,2384,0,NA,5.377,301,1,NA,NA,NA,NA,NA,NA,NA
"2020-05-14",7,2382,7,0,2382,0,NA,5.28,300,5,NA,NA,NA,NA,NA,NA,NA
"2020-05-13",1,2375,1,0,2375,0,NA,6.062,295,1,NA,NA,NA,NA,NA,NA,NA
"2020-05-12",4,2374,4,0,2374,0,NA,7.039,294,2,NA,NA,NA,NA,NA,NA,NA
"2020-05-11",2,2370,2,0,2370,0,NA,8.115,292,3,NA,NA,NA,NA,NA,NA,NA
"2020-05-10",4,2368,4,0,2368,0,NA,8.506,289,5,NA,NA,NA,NA,NA,NA,NA
"2020-05-09",2,2364,2,0,2364,0,NA,8.311,284,3,NA,NA,NA,NA,NA,NA,NA
"2020-05-08",6,2362,6,0,2362,0,NA,9.288,281,0,NA,NA,NA,NA,NA,NA,NA
"2020-05-07",8,2356,8,0,2356,0,NA,9.093,281,1,NA,NA,NA,NA,NA,NA,NA
"2020-05-06",9,2348,9,0,2348,0,NA,8.702,280,1,NA,NA,NA,NA,NA,NA,NA
"2020-05-05",5,2339,5,0,2339,0,NA,8.897,279,3,NA,NA,NA,NA,NA,NA,NA
"2020-05-04",1,2334,1,0,2334,0,NA,9.484,276,1,NA,NA,NA,NA,NA,NA,NA
"2020-05-03",2,2333,2,0,2333,0,NA,10.07,275,4,NA,NA,NA,NA,NA,NA,NA
"2020-05-02",2,2331,2,0,2331,0,NA,10.853,271,0,NA,NA,NA,NA,NA,NA,NA
"2020-05-01",1,2329,1,0,2329,0,NA,12.319,271,6,NA,NA,NA,NA,NA,NA,NA
"2020-04-30",15,2328,15,0,2328,0,NA,15.35,265,1,NA,NA,NA,NA,NA,NA,NA
"2020-04-29",11,2313,11,0,2313,0,NA,18.185,264,4,NA,NA,NA,NA,NA,NA,NA
"2020-04-28",15,2302,15,0,2302,0,NA,19.261,260,7,NA,NA,NA,NA,NA,NA,NA
"2020-04-27",6,2287,6,0,2287,0,NA,23.563,253,4,NA,NA,NA,NA,NA,NA,NA
"2020-04-26",2,2281,2,0,2281,0,NA,25.909,249,5,NA,NA,NA,NA,NA,NA,NA
"2020-04-25",12,2279,12,0,2279,0,NA,30.798,244,8,NA,NA,NA,NA,NA,NA,NA
"2020-04-24",4,2267,4,0,2267,0,NA,37.837,236,7,NA,NA,NA,NA,NA,NA,NA
"2020-04-23",4,2263,4,0,2263,0,NA,41.65,229,6,NA,NA,NA,NA,NA,NA,NA
"2020-04-22",11,2259,11,0,2259,0,NA,45.952,223,11,NA,NA,NA,NA,NA,NA,NA
"2020-04-21",11,2248,11,0,2248,0,NA,49.276,212,8,NA,NA,NA,NA,NA,NA,NA
"2020-04-20",7,2237,7,0,2237,0,NA,51.036,204,4,NA,NA,NA,NA,NA,NA,NA
"2020-04-19",10,2230,10,0,2230,0,NA,52.503,200,2,NA,NA,NA,NA,NA,NA,NA
"2020-04-18",17,2220,17,0,2220,0,NA,56.903,198,7,NA,NA,NA,NA,NA,NA,NA
"2020-04-17",32,2203,32,0,2203,0,NA,60.52,191,4,NA,NA,NA,NA,NA,NA,NA
"2020-04-16",44,2171,44,0,2171,0,NA,64.431,187,10,NA,NA,NA,NA,NA,NA,NA
"2020-04-15",22,2127,22,0,2127,0,NA,66.875,177,4,NA,NA,NA,NA,NA,NA,NA
"2020-04-14",59,2105,59,0,2105,0,NA,71.373,173,8,NA,NA,NA,NA,NA,NA,NA
"2020-04-13",30,2046,30,0,2046,0,NA,72.644,165,8,NA,NA,NA,NA,NA,NA,NA
"2020-04-12",52,2016,52,0,2016,0,NA,78.412,157,7,NA,NA,NA,NA,NA,NA,NA
"2020-04-11",84,1964,84,0,1964,0,NA,79.585,150,17,NA,NA,NA,NA,NA,NA,NA
"2020-04-10",43,1880,43,0,1880,0,NA,81.736,133,5,NA,NA,NA,NA,NA,NA,NA
"2020-04-09",48,1837,48,0,1837,0,NA,85.061,128,16,NA,NA,NA,NA,NA,NA,NA
"2020-04-08",45,1789,45,0,1789,0,NA,87.114,112,6,NA,NA,NA,NA,NA,NA,NA
"2020-04-07",29,1744,29,0,1744,0,NA,90.536,106,6,NA,NA,NA,NA,NA,NA,NA
"2020-04-06",22,1715,22,0,1715,0,NA,96.304,100,8,NA,NA,NA,NA,NA,NA,NA
"2020-04-05",55,1693,55,0,1693,0,NA,104.126,92,6,NA,NA,NA,NA,NA,NA,NA
"2020-04-04",54,1638,54,0,1638,0,NA,103.833,86,4,NA,NA,NA,NA,NA,NA,NA
"2020-04-03",72,1584,72,0,1584,0,NA,103.246,82,3,NA,NA,NA,NA,NA,NA,NA
"2020-04-02",69,1512,69,0,1512,0,NA,105.495,79,4,NA,NA,NA,NA,NA,NA,NA
"2020-04-01",68,1443,68,0,1443,0,NA,110.383,75,1,NA,NA,NA,NA,NA,NA,NA
"2020-03-31",72,1375,72,0,1375,0,NA,107.743,74,9,NA,NA,NA,NA,NA,NA,NA
"2020-03-30",89,1303,89,0,1303,0,NA,105.104,65,7,NA,NA,NA,NA,NA,NA,NA
"2020-03-29",64,1214,64,0,1214,0,NA,102.757,58,12,NA,NA,NA,NA,NA,NA,NA
"2020-03-28",106,1150,106,0,1150,0,NA,100.117,46,3,NA,NA,NA,NA,NA,NA,NA
"2020-03-27",77,1044,77,0,1044,0,NA,93.567,43,5,NA,NA,NA,NA,NA,NA,NA
"2020-03-26",69,967,69,0,967,0,NA,90.536,38,10,NA,NA,NA,NA,NA,NA,NA
"2020-03-25",80,898,80,0,898,0,NA,84.083,28,0,NA,NA,NA,NA,NA,NA,NA
"2020-03-24",88,818,88,0,818,0,NA,76.75,28,3,NA,NA,NA,NA,NA,NA,NA
"2020-03-23",102,730,102,0,730,0,NA,69.808,25,4,NA,NA,NA,NA,NA,NA,NA
"2020-03-22",52,628,52,0,628,0,NA,60.325,21,10,NA,NA,NA,NA,NA,NA,NA
"2020-03-21",48,576,48,0,576,0,NA,55.436,11,5,NA,NA,NA,NA,NA,NA,NA
"2020-03-20",95,528,95,0,528,0,NA,50.841,6,3,NA,NA,NA,NA,NA,NA,NA
"2020-03-19",119,433,119,0,433,0,NA,41.846,3,2,NA,NA,NA,NA,NA,NA,NA
"2020-03-18",41,314,41,0,314,0,NA,30.211,1,0,NA,NA,NA,NA,NA,NA,NA
"2020-03-17",45,273,45,0,273,0,NA,26.398,1,0,NA,NA,NA,NA,NA,NA,NA
"2020-03-16",65,228,65,0,228,0,NA,22.194,1,0,NA,NA,NA,NA,NA,NA,NA
"2020-03-15",37,163,37,0,163,0,NA,15.839,1,0,NA,NA,NA,NA,NA,NA,NA
"2020-03-14",39,126,39,0,126,0,NA,12.221,1,0,NA,NA,NA,NA,NA,NA,NA
"2020-03-13",46,87,46,0,87,0,NA,0,1,0,NA,NA,NA,NA,NA,NA,NA
"2020-03-12",3,41,3,0,41,0,NA,0,1,1,NA,NA,NA,NA,NA,NA,NA
"2020-03-11",5,38,5,0,38,0,NA,0,0,0,NA,NA,NA,NA,NA,NA,NA
"2020-03-10",17,33,17,0,33,0,NA,0,0,0,NA,NA,NA,NA,NA,NA,NA
"2020-03-09",5,16,5,0,16,0,NA,0,0,0,NA,NA,NA,NA,NA,NA,NA
"2020-03-08",2,11,2,0,11,0,NA,0,0,0,NA,NA,NA,NA,NA,NA,NA
"2020-03-07",1,9,1,0,9,0,NA,0,0,0,NA,NA,NA,NA,NA,NA,NA
"2020-03-06",3,8,3,0,8,0,NA,0,0,0,NA,NA,NA,NA,NA,NA,NA
"2020-03-05",0,5,0,0,5,0,NA,0,0,0,NA,NA,NA,NA,NA,NA,NA
"2020-03-04",2,5,2,0,5,0,NA,0,0,0,NA,NA,NA,NA,NA,NA,NA
"2020-03-03",2,3,2,0,3,0,NA,0,0,0,NA,NA,NA,NA,NA,NA,NA
"2020-03-02",0,1,0,0,1,0,NA,0,0,0,NA,NA,NA,NA,NA,NA,NA
"2020-03-01",0,1,0,0,1,0,NA,0,0,0,NA,NA,NA,NA,NA,NA,NA
"2020-02-29",1,1,1,0,1,0,NA,0,0,0,NA,NA,NA,NA,NA,NA,NA
